30
15
1
0,19
                              
                              
   ***                        
  *  *                        
  *    *                      
 ** ** *                   ** 
 **    *                  *   
  **  **                  *** 
  **  *                       
  *   *                       
  *   *                       
  *   *                       
  *  *                        
   * *                        
                              
